OOOOOOOOOOOOOOOOOOOOOOOOOOOOOOOOOOOOOOOOOOOOOOOOO
O                   OOO                       OOO
O OOOOOOOOOOOOOOOOOOOOO OOOOOOOOOOOOOOOOOOOO OOOO
O           OO     OO   O              OO  O OOOO
OOOOOOOOOOO OOOOOOOO  OOOO                 O OOOO
O           OO    OO O OOOOOOOOOOOOO OOOOO   OOOO
O OOOOOOOOOOOOOOOOOO.O.OOOOOOOOOOOOO.OOOOOOOOOOOO
O                                O    O         O
OOOOOOOOOOOOOOOOOOOOOOOOOOOOOOOOOOOO OOOOOOOOOOOO
O                   O        O                OOO
OOOOOOOOOOOOOOOOOOOOOOOOOOO OOOOOOOOOOOOO OOOOOOO
OO               O                  O      OOOOOO
OOO              O                       OOOOOOOO
OOOOOOOOOO OOOOOOOOOOOOOOOOO.OOOOOOOOOOOOOOOOOOOO
OOOOOOOOOO                                   OOOO
OOOOOOOOOOOOOOOOOOOOOOOOOOOOOOOOOOOOOOOOOOUOOOOOO